0000000000000000000000
0                    0
0                    0
0                    0
0   6666             0
0                    0
0                    0
0                    0
0  .               A 0
0                    0
0                    0
0   6666             0
0                    0
0     A              0
0                    0
0000000000000000000000