0000000000
0        0
0        0
0        0
0        0
0  .    A0
0        0
0        0
0        0
0000000000