0000000000
0      A 0
01       0
01       0
01       0
01       0
01       0
0 .      0
0        0
0000000000