0000000000
0        0
0        0
0        0
0      . 0
0        0
0111     0
0        0
0   A    0
0000000000