0000000000
0        0
0   F    0
0        0
0        0
0        0
0        0
0        0
0  .     0
0000000000