0000000000
0 11111110
0        0
0  .     0
0        0
0        0
0        0
0        0
0      D 0
0000000000