0000000000
0        0
01111111 0
0        0
0        0
0    D   0
0        0
0 .      0
0        0
0000000000